0 0 5 5 0 0
0 5 5 5 5 0 1
0 5 5 5 5 0
0 0 0 0 0 0 1 2 3 4 1
5 5 5 5 5 5
5 4 5 5 4 5
5 4 5 5 4 5
5 5 5 5 5 5
5 5 5 5 5 5
5 2 2 2 2 5
5 5 5 5 5 5
1 1 1 1 1 1
